NO ./textures/brick/yellow_brick.xpm
SO ./textures/brick/blue_brick.xpm
WE ./textures/brick/grey_brick.xpm
EA ./textures/brick/purple_brick.xpm


F       0, 124, 45

C 		102, 178, 255


        1111111111111111111111111
        1000000000110000000000001
        1011000001110000011111111
        1001000000000000000000001111
111111111101100000111000000000000101
100000000001000001110111111111111001
111101111111110101000000100011111001
11110111111111000001010010001 110001
11000000110101011100000010011  11111
10000000001110000000000000001
10000000000000000110011011000111111111111
11000001111111011111011110E000000001
11100111 1110001 111011 10001111111
11100111 1111011 111011 11111
1111011  11110111100011
1000001  1100000000011
1111111  111111111111