NO      ./textures/walls/wood.xpm

SO 		./textures/walls/bluewall.xpm
WE 		./textures/walls/pinkwall.xpm

EA     ./textures/walls/greenwall.xpm


F       0, 124, 45

C 		102, 178, 255

111111111111111111111111111111
111111111000000000000000011111
100000000000000000111000100001
110000100000000000000000001111
100001111111000000000000111111
1111111000000000W0000000000001
111100000000001100000000000011
110000000000011110000000000011
100000000000111000000000000011
11000000000011100000000000111111
110000000001111000000000000111
111111111111111111111111111111111