NO      ./textures/wood.xpm

SO 		./textures/bluewall.xpm
WE 		./textures/pinkwall.xpm

EA     ./textures/greenwall.xpm


F       0, 124, 45

C 		102, 178, 255


        1111111111111111111111111
        1000000000110000000000001
        1011000001110000000000001
        1001000000000000000000001111
111111111101100000111000000000000101
100000000001000001010111111111111001
111101111111110110000000100011111001
11110111111111000001010010001 110001
11000000110101011100000010011  11111
10000000000000000000000000001
100000000000000011010100100011111111
11000001110101011111011110E000000001
11110111 1110101 101111010001111111
11111111 1111111 11111111111
1111111
1000001
1111111