NO ./textures/wolfstein/bluestone.xpm
SO ./textures/wolfstein/colorstone.xpm
WE ./textures/wolfstein/greystone.xpm
EA ./textures/wolfstein/mossy.xpm

F 87,108,67
C 98,122,157

              11111111111111111111111111
            110000000000000000000000000011
          1100000000111111111111110000000011
        11000000001100000000000000110000000011
      110000000011000011111111110000110000000011
    1100000000110000110000000000110000110000000011
  11000000001100001100001111110000110000110000000011
11E000000011000011000011000000110000110000110000000011
  11000000001100001100001111110000110000110000000011
    1100000000110000110000000000110000110000000011  
      110000000011000011111111110000110000000011
        11000000001100000000000000110000000011
          1100000000111111111111110000000011
            110000000000000000000000000011
              11111111111111111111111111