NO      ./textures/wood.xpm

SO 		./textures/bluewall.xpm
WE 		./textures/pinkwall.xpm

EA     ./textures/greenwall.xpm


F       0, 124, 45

C 		102, 178, 255

111111111111111111111111111111
111111111000000000000000011111
100000D00000000000111000100001
1100001000000000000000000D1111
100001111111000000000000111111
1111D11000000000W0000000000001
111100000000001100000000000011
110000000000011110000000000011
100000000000111000000000000011
1100000000000D0000000000111111
110000000001111000000000000111
111111111111111111111111111111111