NO      ./textures/ismirand.xpm


SO 		./textures/wolfstein/colorstone.xpm
WE ./textures/wolfstein/greystone.xpm



F        255	 ,  100,0

EA     		    	  ./textures/wolfstein/mossy.xpm
C 225,30,0


        1111111111111111111111111
        1000000000110000000000001
        1011000001110000000000001
        1001000000000000000000001111
111111111101100000111000000000000101
100000000001000001110111111111111001
111101111111110111000000100011111001
11110111111111011101010010001 110001
11000000110101011100000000011  11111
10000000000000000000000000001
10000000000000001101010010001
11000001110101011111011110N011111111111
11110111 1110101 101111010001
11111111 1111111 11111111111
1111111
1000001
1111111