NO      ./textures/walls/wood.xpm

SO 		./textures/walls/pinkwall.xpm
WE 		./textures/walls/bluewall.xpm

EA     ./textures/walls/greenwall.xpm

C      255,0,255

F 		0,255,0


        1111111111111111111111111
        1000000000110000000000001
        1011000001110000011111111
        1001000000000000000000001111
111111111101100000111000000000000101
100000000001000001110111111111111001
1111D11111111101D1000000100011111001
11110111111111000001010010001 110001
11000000110101011100000010011  11111
10000000001110000D000000D0001
1000000000D000000110011011000111111111111
11000001111111D11111011110E000000001
11100111 1110001 111011 10001111111
11100111 1111011 111D11 11111
1111D11  11110111100011
1000001  1100000000011
1111111  111111111111